........................
........................
........................
....................123.
.11113333332211333334444