444444444441442444444444
444444444411142444444444
444444444121112444444444
........1111111.........
.......111111111........
.........11111..........
.........11211..........
333333333112113333333333
........................
........................
........................